"filename", "language", "TypeScript", "XML", "Less", "comment", "blank", "total"
"d:\GitProject\my-projects\blogWebSites\blog\articles\草稿\HTML_RTS_Demo\vite-project\src\BattleField.ts", "TypeScript", 49, 0, 0, 0, 1, 50
"d:\GitProject\my-projects\blogWebSites\blog\articles\草稿\HTML_RTS_Demo\vite-project\src\Game.ts", "TypeScript", 36, 0, 0, 0, 1, 37
"d:\GitProject\my-projects\blogWebSites\blog\articles\草稿\HTML_RTS_Demo\vite-project\src\Map.ts", "TypeScript", 18, 0, 0, 0, 2, 20
"d:\GitProject\my-projects\blogWebSites\blog\articles\草稿\HTML_RTS_Demo\vite-project\src\Operator.ts", "TypeScript", 64, 0, 0, 3, 1, 68
"d:\GitProject\my-projects\blogWebSites\blog\articles\草稿\HTML_RTS_Demo\vite-project\src\Player.ts", "TypeScript", 12, 0, 0, 0, 1, 13
"d:\GitProject\my-projects\blogWebSites\blog\articles\草稿\HTML_RTS_Demo\vite-project\src\Unit.ts", "TypeScript", 18, 0, 0, 0, 5, 23
"d:\GitProject\my-projects\blogWebSites\blog\articles\草稿\HTML_RTS_Demo\vite-project\src\counter.ts", "TypeScript", 9, 0, 0, 0, 1, 10
"d:\GitProject\my-projects\blogWebSites\blog\articles\草稿\HTML_RTS_Demo\vite-project\src\interfaces\Animatable.ts", "TypeScript", 3, 0, 0, 0, 0, 3
"d:\GitProject\my-projects\blogWebSites\blog\articles\草稿\HTML_RTS_Demo\vite-project\src\main.ts", "TypeScript", 6, 0, 0, 18, 5, 29
"d:\GitProject\my-projects\blogWebSites\blog\articles\草稿\HTML_RTS_Demo\vite-project\src\style.less", "Less", 0, 0, 22, 1, 2, 25
"d:\GitProject\my-projects\blogWebSites\blog\articles\草稿\HTML_RTS_Demo\vite-project\src\typescript.svg", "XML", 0, 1, 0, 0, 0, 1
"d:\GitProject\my-projects\blogWebSites\blog\articles\草稿\HTML_RTS_Demo\vite-project\src\vite-env.d.ts", "TypeScript", 0, 0, 0, 1, 1, 2
"Total", "-", 215, 1, 22, 23, 20, 281